a break with tradition - zerwanie z tradycją
acculturation - akulturacja
altruism - altruizm
antisocial - aspołeczny
apartheid - apartheid
assimilation - asymilacja
behaviour - zachowanie
census - spis ludności
civil disobedience - nieposłuszeństwo obywatelskie
civil society - społeczeństwo obywatelskie
colour bar - segregacja rasowa
cultural diffusion - dyfuzja kulturowa
culture shock - szok kulturowy
developing country - kraj rozwijający się
dual nationality - podwójne obywatelstwo
ethnic group - grupa etniczna
fanaticism - fanatyzm
freemasonry - masoneria; wolnomularstwo
functional illiteracy - analfabetyzm funkcjonalny
ghetto - getto
global village - globalna wioska
globalization - globalizacja
hierarchy - hierarchia
homeless - bezdomny
homelessness - bezdomność
homo sovieticus - homo sovieticus
ideology - ideologia
illiteracy - analfabetyzm
integration - integracja
landed gentry - ziemianie; ziemiaństwo
local community - społeczność lokalna
mass society - społeczeństwo masowe
middle class - klasa średnia
nation - naród
norm - norma
patriot - patriota
patriotic - patriotyczny
patriotism - patriotyzm
peer group - grupa rówieśnicza
primary group - grupa pierwotna
proletariat - proletariat
secondary group - grupa wtórna
social alienation - alienacja
social class - klasa społeczna
social communication - komunikacja społeczna
social contract - umowa społeczna
social development - rozwój społeczny
social fact - fakt społeczny
social group - grupa społeczna
social identity - tożsamość społeczna
social interaction - interakcja społeczna
social movement - ruch społeczny
social order - ład społeczny
social relation - stosunek społeczny
social structure - struktura społeczna
social unit - jednostka społeczna
society - społeczeństwo
standard of living - stopa życiowa
struggle for existence - walka o przetrwanie
women's rights - prawa kobiet
airtime - czas antenowy
announce - ogłosić
broadcast - nadawać; transmitować
cable television - telewizja kablowa
censorship - cenzura
channel - kanał
circulation - nakład
columnist - felietonista
commentator - komentator
commercial television - telewizja prywatna
daily - dziennik
editorial board - zespół redakcyjny
freedom of the press - wolność prasy
front page - strona tytułowa
hoax - kaczka dziennikarska
interview - rozmowa; wywiad
investigative journalist - dziennikarz śledczy
journalism - dziennikarstwo
journalist - dziennikarz; dziennikarka
listener - słuchacz
magazine - magazyn
mass media - środki masowego przekazu
news agency - agencja prasowa
news - wiadomość
paparazzi - paparazzi; paparazzo
periodical - czasopismo
press photographer - fotoreporter
press release - komunikat prasowy
press statement - komunikat prasowy
prime time - najlepszy czas antenowy
radio - radio
to read an article - czytać artykuł
reader - czytelnik
reporter - reporter
spokesman - rzecznik prasowy (mężczyzna)
statement - oświadczenie
supplement - dodatek
technical journal - czasopismo specjalistyczne
the press - prasa
viewer - widz
war correspondent - korespondent wojenny
weekly - tygodnik
agreement - porozumienie
kingdom - królestwo
to appoint - mianować
legislative - ustawodawczy
bill - ustawa
lower house - izba niższa
budget - budżet
member - członek
coalition - koalicja
military coup - wojskowy zamach stanu
to come into power - dojść do władzy
minister - minister
committee - komitet
ministry - ministerstwo
communist - komunista; komunistyczny
monarchy - monarchia
constitution - konstytucja
nationalist - nacjonalista
consulate - konsulat
opposition - opozycja
coup - zamach stanu
parliament - parlament
crown - korona
parliamentary - parlamentarny
debate - debata
peace plan - plan pokojowy
to debate - debatować
peaceful protest - pokojowy protest
decree - dekret
policy - polityka
demagogy - demagogia
political - polityczny
democracy - demokracja
political beliefs - poglądy polityczne
democrat - demokrata
political party - partia polityczna
democratic - demokratyczny
political system - system polityczny
dictator - dyktator
politically aware - świadomy politycznie
dictatorship - dyktatura
politician - polityk
diplomacy - dyplomacja
politics - polityka
diplomatic - dyplomatyczny
president - prezydent
diplomatic corps - korpus dyplomatyczny
presidential - prezydencki
diplomatic relations - stosunki dyplomatyczne
prime minister - premier
dismissal - dymisja
prince - książę
dissent from the party line - odejście od linii
princess - księżniczka partyjnej
queen - królowa
embassy - ambasada
reform - reforma
executive - wykonawczy
reformer - reformator
executive branch - władza wykonawcza
reign - panowanie
to exercise authority - sprawować władzę
to reject a bill - odrzucić ustawę
fascism - faszyzm
republic - republika
federation - federacja
royal - królewski
finance policy - polityka finansowa
satellite state - państwo satelickie
fiscal policy - polityka skarbowa
security - bezpieczeństwo; ochrona
foreign policy - polityka zagraniczna
senate - senat
government - rząd
senator - senator
governor - gubernator
social democracy - socjaldemokracja
head of state - głowa państwa
state - państwo; państwowy
headed by - pod przewodnictwem
statesman - mąż stanu
to hold office - sprawować urząd
support - poparcie
home waters - wody terytorialne
supporter - zwolennik
house of parliament - izba parlamentu
takeover - przejęcie władzy
ideology - ideologia
treaty - traktat
immunity - immunitet
unrest - niepokój; wzburzenie; zamieszki
in the international field - na polu międzynarodowym upheaval - przewrót
to introduce a bill - wprowadzić ustawę
veto - weto
king - król
a secret ballot - tajne głosowanie
to abstain from voting - wstrzymywać się od głosowania
abstention - wstrzymanie się od głosu
ballot - karta do głosowania
ballot box - urna wyborcza
to battle for votes - walczyć o głosy
block vote - głosowanie pośrednie
borough - okręg wyborczy
by-election - wybory uzupełniające
candidate - kandydat
to cast a ballot - wrzucić kartę do głosowania
Central Election Committee - Centralna Komisja Wyborcza
election campaign - kampania wyborcza
election fraud - oszustwo wyborcze
electoral system - ordynacja wyborcza
forthcoming elections - nadchodzące wybory
free election - wolne wybory
full results - pełne rezultaty
general election - wybory powszechne
to hold an election - przeprowadzać wybory
international observers - obserwatorzy międzynarodowi
one of the candidates - jeden z kandydatów
polling day - dzień wyborów
polling station - lokal wyborczy
polling-booth - kabina wyborcza
presidential election - wybory prezydenckie
to promise change - obiecywać zmianę/zmiany
to receive forty two percent of the vote - otrzymać 42% głosów
second round of election - druga tura wyborów
victory - zwycięstwo
vote - głos
to vote - głosować
voter - wyborca
voter list - lista uprawnionych do głosowania
voting has been peaceful - głosowanie przebiegło spokojnie
application for asylum - podanie o azyl
to ask for political asylum - prosić o azyl
asylum camp - obóz dla uchodźców
asylum request - prośba o azyl
asylum seeker - uchodźca
chauvinism - szowinizm
colour of skin - kolor skóry
deportation - deportacja
discrimination - dyskryminacja
displaced person - wysiedleniec
displacement - wysiedlenie
to emigrate - emigrować; wyemigrować
equality - równość
ethnic cleansing - czystka etniczna
ethnic group - grupa etniczna
foreign - obcy; zagraniczny
foreigner - cudzoziemiec
to give sb asylum - udzielić komuś azylu
hatred of foreigners - nienawiść wobec cudzoziemców
homesickness - tęsknota za domem
illegal immigrant - nielegalny imigrant
immigration policy - polityka imigracyjna
integration - integracja
migrant boat - łódź z imigrantami
to migrate - migrować
migration - migracja
minority - mniejszość
multiculturalism - wielokulturowość
nationalism - nacjonalizm
nationalist - nacjonalista
political asylum - azyl polityczny
prejudice - uprzedzenie
race - rasa
racism - rasizm
racist - rasista
refugee - uchodźca
refugee camp - obóz dla uchodźców
right of asylum - prawo azylu
to start a new life - rozpocząć nowe życie
tolerant - tolerancyjny
xenophobia - ksenofobia
xenophobic - ksenofobiczny
almighty - wszechmogący
altar - ołtarz
angel - anioł
to anoint - namaszczać
apocalypse - apokalipsa
archangel - archanioł
archbishop - arcybiskup
ascension - wniebowstąpienie
atheist - ateista
bishop - biskup
blasphemy - bluźnierstwo
blessed - błogosławiony
catechism - katechizm
celibacy - celibat
christening - chrzest
Christian - chrześcijanin
Christianity - chrześcijaństwo
church - kościół
clergy - duchowieństwo; kler
clergyman - duchowny
to consecrate - święcić; poświęcić
to contemplate - kontemplować
creator - stwórca
cross - krzyż
death - śmierć
deity - bóstwo
denomination - wyznanie
to desecrate - bezcześcić; zbezcześcić
devil - diabeł
devotee - wierny
devotion - pobożność
dogma - dogmat
dogmatic - dogmatyczny
ecumenical - ekumeniczny
emotional sermon - emocjonalne kazanie
eternal - wieczny
eternity - wieczność
evangelical - ewangelicki
evangelist - kaznodzieja
to evangelize - głosić ewangelię
faith - wiara
freedom of religion - wolność wyznania
to go to mass - iść na mszę
God - Bóg
goddess - bogini
guardian angel - anioł stróż
heaven - niebo
hell - piekło
holy - święty
incarnation - wcielenie
Islam - islam
Islamic - islamski
kosher - koszerny
life everlasting - życie pozagrobowe
mass - msza
to meditate - medytować
miracle - cud
missal - mszał
monastery - klasztor
monk - mnich; zakonnik
Muslim - muzułmanin
New Testament - Nowy Testament
nun - zakonnica
Old Testament - Stary Testament
paradise - raj
parish - parafia
parishioner - parafianin
pope - papież
pray - modlić się
prayer - modlitwa
prayer book - modlitewnik
to preach - głosić; wygłaszać kazanie
preacher - kaznodzieja
prelate - prałat
prophecy - proroctwo; przepowiednia
to prophesy - prorokować; przepowiadać
prophet - prorok
prophetic - proroczy
rabbi - rabin
religion - religia; wiara
religious - religijny
sacrament - sakrament
sacrilegious - świętokradczy
saint - święty
to say one's prayers - modlić się; pomodlić się
sect - sekta
seminary - seminarium
sermon - kazanie
shaman - szaman
shrine - miejsce kultu
sin - grzech
soul - dusza
synagogue - synagoga
temple - świątynia
Ten Commandments - dziesięć przykazań
theology - teologia
vestry - zakrystia
vicar - pastor (kościoła anglikańskiego)
vicarage - plebania (w kościele anglikańskim)
worship - nabożeństwo
abdication - abdykacja
absolutism - absolutyzm
ancient - starożytny
antiquity - antyk
barbarian - barbarzyńca
Byzantium - Bizancjum
chronicle - kronika
chronology - chronologia
cold war - zimna wojna
colonial - kolonialny
to colonize - kolonizować
colony - kolonia
Congress of Vienna - Kongres Wiedeński
conqueror - zdobywca
conquest - podbój
contemporary history - historia współczesna
Counter-Reformation - kontrreformacja
Duchy of Warsaw - Księstwo Warszawskie
dynasty - dynastia
empire - imperium
expansion - ekspansja
feudalism - feudalizm
First World War - pierwsza wojna światowa
heritage - dziedzictwo; spuścizna
historic - historyczny
history of Poland - historia Polski
imperialism - imperializm
knight - rycerz
legend - legenda
Marshall Plan - Plan Marshalla
medieval - średniowieczny
Middle Ages - średniowiecze
partition - rozbiór
piracy - piractwo
pirate - pirat
prince - książę
princess - księżniczka
reformation - reformacja
royal - królewski
Second World War - druga wojna światowa
slave - niewolnik
slavery - niewolnictwo
Soviet Union - Związek Socjalistycznych Republik Radzieckich
Treaty of Versailles - Traktat Wersalski
tribal - plemienny
tribe - plemię
uprising - powstanie
administrative centre - centrum administracyjne
agglomeration - aglomeracja
avenue - aleja
bazaar - bazar
belfry - dzwonnica
belt of greenery - pas zieleni
block - blok
block of flats - blok mieszkalny
boulevard - bulwar
bridge - most
building - budynek
bustling - ruchliwy
car park - parking
castle - zamek; zamkowy
cathedral - katedra
cemetery - cmentarz
central - centralny
centre; center - centrum
church - kościół
city - miasto (większe)
city hall - ratusz
city market - targowisko miejskie
city-dweller - mieszkaniec miasta
cobbled streets - brukowane ulice
column - kolumna
congested - zatłoczony
council - rada miasta
councillor - radny
crowded - zatłoczony
curb (AM) - krawężnik
deprived district - dzielnica biedy
development - osiedle
district - dzielnica
downtown (AM) - śródmieście
factory - fabryka
flower bed - klomb
fortress - forteca
fountain - fontanna
garden - ogród
ghost-town - miasto duchów; wymarłe miasto
graveyard - cmentarz
historical city - zabytkowe miasto
historical monument - zabytek
hospital - szpital
housing estate - osiedle
industrial city - miasto przemysłowe
inscription - napis
kerb - krawężnik
landmark - punkt zwrotny; przełomowe wydarzenie
lane - alejka
little town - miasteczko
metropolis - metropolia
modern - nowoczesny
monastery - klasztor
monument - pomnik
municipal - miejski
museum - muzeum
neon light - neon
office building - biurowiec
old market - stary rynek
old town - stare miasto
outer suburbs - odległe przedmieścia
outskirts - przedmieścia; obrzeża miasta
palace - pałac
park - park
paved - brukowany
pavement - chodnik
pawnshop - lombard
pedestrian crossing - przejście dla pieszych
picturesque city - malownicze miasto
playground - plac zabaw
police station - posterunek policji
poor quarter - dzielnica biedy
post office - poczta
promenade - deptak; promenada
quarter - dzielnica
red brick building - budynek z czerwonej cegły
rich quarter - dzielnica bogatych
road - droga
roundabout - rondo
ruins - ruiny
school - szkoła
shanty town - dzielnica slumsów
sidewalk (AM) - chodnik
skyscraper - drapacz chmur
smog - smog
square - plac
street - ulica
street lamp - latarnia uliczna
street lightning - oświetlenie uliczne
street map - plan miasta
street plan - plan miasta
suburb - przedmieście
subway (AM) - metro
suspended bridge - most wiszący
tower - wieża
tower block - wieżowiec
town - miasto (małe i średnie)
town hall - ratusz
traffic jam - korek uliczny
underground - metro
university city - miasto uniwersyteckie
urban - miejski
wall - mur
yard - dziedziniec
agricultural - rolniczy
agriculture - rolnictwo
back off beyond - zapadła dziura
boredom - nuda
boring - nudny
brood hen - kwoka nioska
calm - spokój; spokojny
country - wieś (obszar wiejski)
country cottage - chata
countryside - krajobraz wiejski
cowshed - obora
croft - zagroda
crop spraying - opylanie zbiorów
to cultivate - uprawiać
dung - gnój
farm - farma; gospodarstwo rolne
farmer - rolnik
farmhand - robotnik rolny
farming - rolnictwo
farmland - pole uprawne
farmyard - obejście gospodarskie
fence - płot
fertiliser - nawóz
field - pole
folk - ludowy
folk custom - zwyczaj ludowy
gamekeeper - gajowy
harvest - żniwa
harvest festival - dożynki
hay - siano
haystack - stóg siana
hedgerow - żywopłot
in the country - na wsi
intensive farming - intensywna gospodarka rolna
livestock - inwentarz
manure - obornik
meadow - łąka
molehill - kretowisko
mow - kosić
mower - kosiarka
mud floor - klepisko
path - ścieżka
peasant - chłop
pigeon fancier - gołębiarz
plough - pług
provincial - prowincjonalny
quietude - cisza
rail - sztacheta
secluded - odludny
settlement - osada
shed - szopa
sheep farming - hodowla owiec
shepherd - pasterz
soil - gleba
stable - stajnia
straw - słoma
thresh - młócić
thresher - młockarnia
tractor - traktor
tractor driver - traktorzysta
tree - drzewo
village - wieś
village administrator - sołtys
village festival - festyn wiejski
villager - wieśniak
yard - podwórze
Afghan - Afgańczyk
Albanian - Albańczyk
Argentinian - Argentyńczyk
Armenian - Ormianin
Australian - Australijczyk
Austrian - Austriak
Azerbaijani - Azer
Bangladeshi - Banglijczyk
Belarusian; Belarusan - Białorusin
Belgian - Belg
Bolivian - Boliwijczyk
Bosnian - Bośniak
Brazilian - Brazylijczyk
Bulgarian - Bułgar
Cameroonian - Kameruńczyk
Canadian - Kanadyjczyk
Chilean - Chilijczyk
Chinese - Chińczyk
Colombian - Kolumbijczyk
Costa Rican - Kostarykanin
Croat;Croatian - Chorwat
Cuban - Kubańczyk
Cypriot - Cypryjczyk
Czech - Czech
Dane - Duńczyk
Dutchman - Holender
Dutchwoman - Holenderka
Ecuadorean - Ekwadorczyk
Egyptian - Egipcjanin
Englishman - Anglik
Englishwoman - Angielka
Estonian - Estończyk
Ethiopian - Etiopczyk
Filipino - Filipińczuk
Finn - Fin
Frenchman - Francuz
Frenchwoman - Francuzka
Gambian - Gambijczyk
Georgian - Gruzin
German - Niemiec
Greek - Grek
Hungarian - Węgier
Icelander - Islandczyk
Indian - Hindus
Indonesian - Indonezyjczyk
Iranian - Irańczyk
Iraqi - Irakijczyk
Irishman - Irlandczyk
Irishwoman - Irlandka
Italian - Włoch
Jamaican - Jamajczyk
Japanese - Japończyk
Kazakh - Kazach
Kenyan - Kenijczyk
Laotian - Laotańczyk
Latvian - Łotysz
Lebanese - Libańczyk
Libyan - Libijczyk
Lithuanian - Litwin
Macedonian - Macedończyk
Malaysian - Malezyjczyk
Malian - Malijczyk
Maltese - Maltańczyk
Mexican - Meksykanin
Moldovan - Mołdawianin
Mongolian - Mongoł
Montenegrin - Czarnogórzec
Moroccan - Marokańczyk
Nepalese - Nepalczyk
Nigerian - Nigeryjczyk
Norwegian - Norweg
Omani - Omańczyk
Peruvian - Peruwiańczyk
Pole - Polak
Portuguese - Portugalczyk
Romanian - Rumun
Russian - Rosjanin
Scot - Szkot
Senegalese - Senegalczyk
Serb; Serbian - Serb
Slovak - Słowak
Slovene; Slovenian - Słoweniec
Somali - Somalijczyk
Spaniard - Hiszpan
Sri Lankan - Lankijczyk
Sudanese - Sudańczyk
Surinamer; Surinamese - Surinamczyk
Swede - Szwed
Swiss - Szwajcar
Syrian - Syryjczyk
Taiwanese - Tajwańczyk
Tajik; Tadjik - Tadżyk
Thai - Tajlandczyk
Tunisian - Tunezyjczyk
Turk - Turek
Ukrainian - Ukrainiec
Uruguayan - Urugwajczyk
Uzbek - Uzbek
Venezuelan - Wenezuelczyk
Vietnamese - Wietnamczyk
Welshman - Walijczyk
Welshwoman - Walijka
Yemeni - Jemeńczyk
Zambian - Zambijczyk
Zimbabwean - Zimbabwejczyk