aggression - agresja
aggressive - agresywny
aggressiveness - agresywność
to agonize - zadręczać się; przeżywać niepokój
angrily - w złości; w gniewie
angry with sb. - zły na kogoś
to annoy - irytować; drażnić
annoyance - irytacja
annoying - irytujący
to calm down - uspokajać; uspokoić
calmly - spokojnie
calmness - spokój
displeased - niezadowolony
dissatisfaction - niezadowolenie
to drive sb mad - doprowadzać kogoś do szału
to enrage - rozwścieczać; rozwścieczyć
flash of anger - przypływ gniewu
flustered - podenerwowany
furious - wściekły
fury - furia; wściekłość
to infuriate - rozwścieczać; rozwścieczyć
to lose one's nerve - tracić zimną krew
mad - szalony; obłąkany
madman - szaleniec
nerve-racking - wykańczający nerwowo
now don't get upset - tylko się nie denerwuj
overwrought - wyczerpany nerwowo
peeved - wkurzony
rage - wściekłość
to run amok - dostawać amoku
to seethe with anger - kipieć gniewem
she has become angry - zdenerwowała się
aghast - przerażony
anxiety - niepokój; obawa
anxiously - z troską; z obawą
apprehensive - pełen obawy
dauntless - nieustraszony
disquiet - zaniepokojenie
dread - lęk
fear - strach
fear of heights - lęk wysokości
fearless - nieustraszony
foreboding - złe przeczucie
fraught - spięty
frightening - przerażający
frightful - przeraźliwy
to get the fright of one's life - śmiertelnie się przestraszyć
to give sb a scare - napędzać komuś stracha
jittery - roztrzęsiony
panic - panika
restless - niespokojny
restlessly - niespokojnie
scared stiff - śmiertelnie przestraszony
unease - niepokój
a burst of laughter - wybuch śmiechu
blissfully happy - bezgranicznie szczęśliwy
cheerful - wesoły; radosny
elated - rozradowany
elation - rozradowanie
enthusiasm - entuzjazm
exhilarating - radosny
exultant - rozradowany
gaiety - wesołość
gaily - wesoło
glee - radość
gleeful - rozradowany
happy - szczęśliwy
hilarity - wesołość
joy - radość
joyful - radosny; uradowany
to laugh - śmiać się
laugh - śmiech
merrily - wesoło
merriment - wesołość
mirth - rozbawienie; wesołość
to sneer - uśmiechać się szyderczo
to snigger - chichotać; zachichotać
to weep with joy - płakać z radości
with abandon - beztrosko
with joyous abandon - w radosnym uniesieniu
apathetic - apatyczny
apathy - apatia
to bemoan - opłakiwać; żałować
bereaved - pogrążony w smutku/żałobie
bitterness - gorycz; rozgoryczenie
blues - chandra
to burst into tears - wybuchnąć płaczem
chagrin - rozgoryczenie
to cry - płakać
crying - płacz
to cuddle - przytulać
deep sorrow - głęboki żal
dejected - przygnębiony; przybity
dejection - przygnębienie
to deplore - ubolewać
depressing - przygnębiający
desolation - rozpacz
disappointed - rozczarowany; zawiedziony
disappointment - rozczarowanie; zawód
disgruntled - rozczarowanie
disilusionment - rozczarowanie
to dissolve into tears - zalewać się łzami; zalać sie łzami
embittered - rozgoryczony
to exasperate - doprowadzać do rozpaczy
feel miserable - być bardzo przygnębionym
his spirits sagged - upadł na duchu
in the depths od despair - w skrajnej rozpaczy
longing - tęsknota
to mope - rozczulać się nad sobą
mournful - zasmucony; smutny
sad - smutny
to sadden - smucić; zasmucać
sadly - smutko; ze smutkiem
sadness - smutek
she had a good cry - porządnie się wypłakała
she was on the brink of tears - była na skraju łez
teardrop - łza
tearful - zapłakany
tears welled up in her eyes - jej oczy zaszkliły się od łez
to weep - płakać; zapłakać
aversion - niechęć; awersja
to bicker - sprzeczać się
to detest - nienawidzić; nie cierpieć
disfavour (US) - nieprzychylność
dislike - niechęć; antypatia
enemy - wróg
enmity - wrogość
feud - być zwaśnionym
to give sb a wide berth - trzymać się od kogoś z daleka
to hate - nienawidzić
hate - nienawiść
to like - lubić
to look daggers at sb - sztyletować kogoś wzrokiem
love - miłość
to love - kochać
lover - kochanek
to make an enemy of sb - robić sobie z kogoś wroga
malevolence - wrogość
malevolent - wrogi
to quarrel - kłócić się
quarrel - kłótnia
rancour - nienawiść
reluctance - niechęć
respect - szacunek
to respect - szanować
tiff - sprzeczka
anecdote - anekdota
to amuse - śmieszyć; rozśmieszyć
black humour - czarny humor
cabaret - kabaret
cartoonist - karykaturzysta
clown - klaun
to clown about - błaznować
comic - 1. komik 2. komiczny
comical - komiczny
to crack jokes - opowiadać kawały
derision - szyderstwo; drwina
derisive - szyderczy; drwiący
despondent - przybity; przygnębiony
fun - zabawa
funny - zabawny
gallows humour - wisielczy humor
he treated it as a joke - obrócił to w żart
humor - humor
humorist - humorysta; komik
humorless - pozbawiony poczucia humoru
in fun - w żartach
to joke - żartować
joke - dowcip; kawał
joking - żarty
joking apart - żarty na bok
jokingly - żartem; w żartach; na żarty
to laugh - śmiać się
laugh - śmiech
to laugh off - obracać w żart
laughable - śmieszny
laughing gas - gaz rozweselający
laughter - śmiech
mockery - kpina
mocking - kpiący
muck about - wygłupiać się
to play a joke on sb - zrobić komuś kawał
to play a trick on sb - robić komuś kawał
to poke fun at... - stroić sobie żarty z...
practical joke - psikus; figiel
sense of humor - poczucie humoru
standing joke - pośmiewisko
we died of laughing - umieraliśmy ze śmiechu
wry - lekko drwiący